32, 64, 0, 0
1, 1, 62, 30
+--------------------------------------------------------------+
|                                                              |
| #####                                                  ##### |
| ########   ###     #####   ####   #####     ###   ########## |
| #####                                                  ##### |
|   #          ##########  ########  ##########            #   |
|   #        #########       ####       #########          #   |
|   #      ##########        ####        ##########        #   |
|         ###########                    ###########           |
|         ###########                    ###########           |
|   #     ###########                    ###########       #   |
|   #     ###########                    ###########       #   |
|         ##########                      ##########           |
|   #     ####                                  ####       #   |
|   #     #           ######      ######           #       #   |
|   #     #           ##  ##      ##  ##           #       #   |
|   #     #           ##  ##      ##  ##           #       #   |
|   #     #           ######      ######           #       #   |
|   #     ######                              ######       #   |
|         ###########                    ###########           |
|   #     ###########                    ###########       #   |
|   #     ###########                    ###########       #   |
|         ###########      #      #      ###########           |
|         ###########       #    #       ###########           |
|   #            ####        ####        ####              #   |
|   #              ##        ####        ##                #   |
|   #               #     ##########     #                 #   |
| #####              #   #          #   #                ##### |
| ########   ###     #   #          #   #     ###   ########## |
| #####              #   #          #   #                ##### |
|                                                              |
+--------------------------------------------------------------+
