31, 63, 0, 0
1, 1, 3, 3
+-------------------------------------------------------------+
|                                                             |
| # # # # # # # # # # # # # # # # # # # # # # # # # # # # # # |
|                                                             |
| # # # # # # # # # # # # # # # # # # # # # # # # # # # # # # |
|                                                             |
| # # # # # # # # # # # # # # # # # # # # # # # # # # # # # # |
|                                                             |
| # # # # # # # # # # # # # # # # # # # # # # # # # # # # # # |
|                                                             |
| # # # # # # # # # # # # # # # # # # # # # # # # # # # # # # |
|                                                             |
| # # # # # # # # # # # # # # # # # # # # # # # # # # # # # # |
|                                                             |
| # # # # # # # # # # # # # # # # # # # # # # # # # # # # # # |
|                                                             |
| # # # # # # # # # # # # # # # # # # # # # # # # # # # # # # |
|                                                             |
| # # # # # # # # # # # # # # # # # # # # # # # # # # # # # # |
|                                                             |
| # # # # # # # # # # # # # # # # # # # # # # # # # # # # # # |
|                                                             |
| # # # # # # # # # # # # # # # # # # # # # # # # # # # # # # |
|                                                             |
| # # # # # # # # # # # # # # # # # # # # # # # # # # # # # # |
|                                                             |
| # # # # # # # # # # # # # # # # # # # # # # # # # # # # # # |
|                                                             |
| # # # # # # # # # # # # # # # # # # # # # # # # # # # # # # |
|                                                             |
+-------------------------------------------------------------+
