31, 63, 0, 0
1, 1, 61, 29
+-------------------------------------------------------------+
|                                                             |
| # # # # # # # # # # # # # # # # # # # # # # # # # # # # # # |
|                                                             |
| # # # # # # # # # # # # # # # # # # # # # # # # # # # # # # |
|                                                             |
| # # # # # # # # # # # # # # # # # # # # # # # # # # # # # # |
|                                                             |
| # # # # # # # # # # # # # # # # # # # # # # # # # # # # # # |
|                                                             |
| # # # # # # # # # # # # # # # # # # # # # # # # # # # # # # |
|                                                             |
| # # # # # # # # # # # # # # # # # # # # # # # # # # # # # # |
|                                                             |
| # # # # # # # # # # # # # # # # # # # # # # # # # # # # # # |
|                                                             |
| # # # # # # # # # # # # # # # # # # # # # # # # # # # # # # |
|                                                             |
| # # # # # # # # # # # # # # # # # # # # # # # # # # # # # # |
|                                                             |
| # # # # # # # # # # # # # # # # # # # # # # # # # # # # # # |
|                                                             |
| # # # # # # # # # # # # # # # # # # # # # # # # # # # # # # |
|                                                             |
| # # # # # # # # # # # # # # # # # # # # # # # # # # # # # # |
|                                                             |
| # # # # # # # # # # # # # # # # # # # # # # # # # # # # # # |
|                                                             |
| # # # # # # # # # # # # # # # # # # # # # # # # # # # # # # |
|                                                             |
+-------------------------------------------------------------+
