31, 63, 0, 0
SpawnAx, SpawnAy, SpawnBx, SpawnBy
+++++++++++++++++++++++++++++++++++++++++++++++++++++++++++++++
+                                                             +
+ + + + + + + + + + + + + + + + + + + + + + + + + + + + + + + +
+                                                             +
+ + + + + + + + + + + + + + + + + + + + + + + + + + + + + + + +
+                                                             +
+ + + + + + + + + + + + + + + + + + + + + + + + + + + + + + + +
+                                                             +
+ + + + + + + + + + + + + + + + + + + + + + + + + + + + + + + +
+                                                             +
+ + + + + + + + + + + + + + + + + + + + + + + + + + + + + + + +
+                                                             +
+ + + + + + + + + + + + + + + + + + + + + + + + + + + + + + + +
+                                                             +
+ + + + + + + + + + + + + + + + + + + + + + + + + + + + + + + +
+                                                             +
+ + + + + + + + + + + + + + + + + + + + + + + + + + + + + + + +
+                                                             +
+ + + + + + + + + + + + + + + + + + + + + + + + + + + + + + + +
+                                                             +
+ + + + + + + + + + + + + + + + + + + + + + + + + + + + + + + +
+                                                             +
+ + + + + + + + + + + + + + + + + + + + + + + + + + + + + + + +
+                                                             +
+ + + + + + + + + + + + + + + + + + + + + + + + + + + + + + + +
+                                                             +
+ + + + + + + + + + + + + + + + + + + + + + + + + + + + + + + +
+                                                             +
+ + + + + + + + + + + + + + + + + + + + + + + + + + + + + + + +
+                                                             +
+++++++++++++++++++++++++++++++++++++++++++++++++++++++++++++++
