15, 17, 0, 0
2, 2, 14, 15
+---------------+
| # # # # # # # |
|               |
| # # # # # # # |
|               |
| # # # # # # # |
|               |
| # # # # # # # |
|               |
| # # # # # # # |
|               |
| # # # # # # # |
|               |
| # # # # # # # |
+---------------+
