15, 31, 0, 0
1, 1, 29, 13
+-----------------------------+
|                             |
| ######## ######### ######## |
| #            #            # |
| ######## ######### ######## |
| #            #            # |
| ######## ######### ######## |
| #            #            # |
| ######## ######### ######## |
| #            #            # |
| ######## ######### ######## |
|                             |
+-----------------------------+