11, 17, 0, 0
1, 1, 15, 9
#################
#               #
# # # # # # # # #
#               #
# # # # # # # # #
#               #
# # # # # # # # #
#               #
# # # # # # # # #
#               #
#################
